.......................................
.......................................
....................e....e.............
..#####################################
.......................................
...............ooo.....................
...........h..o...o....h...bbbbb.......
..S....................................
.......................................
###...oo...........====.............F..
###...##....C......................WWW.
###..####...WW........e......h....WWWWW
###..####AAA###########################
###..##################################
