.......................................
.......................................
.......................................
.......................................
.......................................
.......................................
.......................................
.......................................
.......................................
.......................................
.......................................
.......................................
.......................................
.......................................
.......................................
.......................................
.......................................
.......................................
.......................................
...................#......#............
...................#......#............
...................#......#............
...................#......#............
...................#......#............
...................#......#............
...................#......#............
...............==..#......#............
...................#......#............
...................#......#............
...............==..#......#............
..................=#.......=#..........
..S..............#.#......=.#..........
##################T########T###########
#######################################
