.......................................
.......................................
.......................................
.......................................
.......................................
...............ooo.....................
..............o...o........bbbbb.......
.......................................
.S.................====................
###...oo............................F..
###...##....C......................WWW.
###..####...WW........e...........WWWWW
###..####AAA###########################
###..##################################
