.......................................
.......................................
.......................................
.......................................
.......................................
...............ooo.....................
..............o...o........bbbbb.......
.......................................
.S.................====................
###...oo...................bbbbb....F..
###...##...........................WWW.
###..####...WW........e...........WWWWW
###..####AAA###########################
###..##################################
