.......................................
.......................................
..S.................e....e.............
..#####################################
.......................................
...............ooo.....................
..............o...o........bbbbb.......
.......................................
.......................................
###...oo...........====.............F..
###...##....C......................WWW.
###..####...WW........e...........WWWWW
###..####AAA###########################
###..##################################
