.......................................
.......................................
.......................................
.......................................
.......................................
.......................................
.......................................
.......................................
.......................................
.......................................
.......................................
.......................................
.......................................
.......................................
.......................................
.......................................
.......................................
.......................................
...................W......W............
...................W......W............
...................W......W............
...................W......W............
...................W......W............
...................W......W............
...................W......W............
...................W......W............
...............==..W......W............
...................W......W............
...................W......W............
...............==..W......W............
..................=W.......=#..........
..S..............#.W......=.#..........
##################T########T###########
#######################################
