...................#...................
...................#...................
...................#...................
...................#...................
...................#...................
...................#...................
...................#...................
...................#...................
...................#...................
...................#...................
...................#...................
...................#...................
...................#...................
...................#...................
...................#...................
...................#...................
...................#...................
...................#...................
...................#...................
...................#...................
...................#...................
...................#...................
...................#...................
...................#...................
...................#...................
...................#...................
...................#...................
...................#...................
...................#...................
...............!...#...................
...................#...................
..S......T.........#...................
#######################################
#######################################
